How	R
can	V
I	O
get	V
a	D
signed	V
Java	^
Applet	^
to	P
perform	V
privileged	A
operations	N
when	R
called	V
from	P
unsigned	A
Javascript	N
?	,

Use	V
the	D
java.security.AccessController	A
class	N
.	,
There	X
is	V
a	D
doPrivilegedAction	N
and	&
doPrivilegedExceptionAction	N
that	O
do	V
exactly	R
what	O
you	O
need	V
.	,
For	P
example	N
:	,
AccessController.doPrivileged	^
(	,
new	A
PrivilegedAction()	^
{	E
public	A
Object	N
run()	E
{	E
..	,
do	V
something	N
that	D
only	A
works	V
with	P
signed	V
applets	N
..	,
}	E
}	E
);	E

It's	L
worth	V
adding	V
:	,
make	V
your	D
privaction'd	^
run()	^
method	N
as	P
small	A
and	&
self-contained	A
as	P
possible	A
.	,
Obviously	R
you	O
could	V
just	R
have	V
your	D
signed	V
applet's	L
init()	A
method	N
call	V
a	D
privileged	A
run()	P
which	D
in	P
turn	V
does	V
the	D
actual	A
applet	N
,	,
but	&
that's	L
just	R
begging	V
to	P
be	V
abused	V
,	,
misused	V
accidentally	R
,	,
or	&
outright	R
exploited	V
.	,
Also	R
,	,
the	D
fact	N
that	P
signed	V
applets	N
lose	V
their	D
special	A
permissions	N
when	R
called	V
by	P
JavaScript	^
is	V
not	R
specific	A
to	P
a	D
particular	A
browser	N
or	&
platform	N
.	,
That's	L
just	R
how	R
it	O
is	V
,	,
everywhere	R
,	,
all	X
the	D
time	N
.	,

