Process	^
the	D
file	N
before	P
uploading	V
it	O

I	O
got	V
a	D
form	N
with	P
SWFUpload	^
.	,
Files	N
uploaded	V
to	P
the	D
server	N
are	V
converted	V
server-side	N
(	,
video	N
being	V
compressed	V
,	,
images	N
being	V
resized	V
etc	G
)	,
Question	N
is	V
-	,
can	V
i	O
delegate	V
some	D
of	P
the	D
functionality	N
to	P
client-side	^
(	,
like	V
image	N
resizing	V
)	,
,	,
to	P
save	V
some	D
bandwidth	N
for	P
user	N
.	,

Video	N
compression	N
via	P
Javascript	^
would	V
probably	R
slow	A
the	D
browser	N
so	R
much	A
that	P
it	O
wouldn't	V
be	V
bandwidth	N
savings	N
and	&
if	P
anything	N
would	V
probably	R
annoy	V
the	D
end	N
user	N
.	,

Thanks	N
,	,
very	R
valid	A
point	N
.	,
Though	P
it	O
doesn't	V
have	V
to	P
be	V
javascript	A
compression	N
.	,
Maybe	R
some	D
process	N
,	,
just	R
initiated	V
by	P
javascript	^
?	,

