@ciaranyree	@
it	O
was	V
on	P
football	N
wives	N
,	,
one	$
of	P
the	D
players	N
and	&
his	D
wife	N
own	N
smash	V
burger	N

RT	~
@TheRealQuailman	@
:	~
Currently	R
laughing	V
at	P
Laker	^
haters	^
.	,

RT	~
@HollywoodOompa	@
:	~
Sat	^
November	^
6	$
ill	R
be	V
at	P
Nashville	^
center	N
stage	N
for	P
the	D
ice	N
kream	N
party	N
for	P

